Join Now - It's Free! Sign up
We recommend enabling JavaScript to experience JAZZRADIO.com properly.
now playing Aston Grey Project - Time After Time (feat. Mila Love)
now playing ChillhopGuru - Dernier MÃ©tro
now playing The Hot Club of Philadelphia - Chez Jacquet
now playing Norman Johnson - Slide
now playing Vinicius De Moraes - Samba Em Preludio
now playing Herb Ellis and Joe Pass - Am I Blue?
now playing Jeff Golub - Let's Talk It Over
now playing Hank Mobley - Carolyn
now playing Falkner Evans Trio - Feel Free
now playing Mel Torme - In The Evening (When The Sun Goes Down)
now playing Braxton Brothers - So Divine
now playing Stan Kenton - Did I Remember
now playing Elan Trotman - Always With You
now playing David Friesen Trio - Equinox
now playing Kid Coconutz - Punch Lines (Nano Mix)
now playing James Torme - Comin' Home Baby
now playing Zimbo Trio - Que Maravilha - Chove Chuva - Mas Que Nada
now playing Marty Grosz - Church Street Sobbin' Blues
now playing Louis Hayes - Soul-Leo
now playing Steve Khan - Street Of Dreams
now playing John Hammond - Traveling Riverside Blues
now playing Frank Sinatra & Count Basie - I Only Have Eyes For You
now playing Oslo Swan - Dreamin
now playing Milt Jackson - Now's the Time
now playing Beegie Adair Trio - Young At Heart
now playing Charlie Spivak - Leave Some
now playing Brian Culbertson - Let's Stay In Tonight
now playing Jazz at Lincoln Center Orchestra - Four by Five
now playing George Michael - Desafinado (feat. Astrud Gilberto)
now playing Eric Clapton - Have You Ever Loved a Woman
now playing Papa Mambo - Blue Barron
now playing Greg Ruby - Inside Out
now playing Marquis Hill - Moon Rays
now playing Wes Montgomery - Lolita
now playing Ella Fitzgerald; Chick Webb & Orch - I Can't Stop Loving You
now playing Ed Cherry - Cloud Dancer
now playing Oliver Nelson - Daylie's Double
now playing Brian Bromberg - Boomerang
now playing Boney James - RPM
Search out channels by style using the filter buttons provided here. Click your favorite to give it a try.